season,event,champion,games_contests,pick_ban_ratio,banned_games,played_games,played_by_number_of_players,win,lose
1,Main,Nunu,27,96.4,9,18,6,12,6
1,Main,Alistar,25,89.3,12,13,4,8,5
1,Main,Rumble,23,82.1,21,2,2,2,0
1,Main,Vladimir,22,78.6,14,8,5,3,5
1,Main,Twisted Fate,22,78.6,18,4,2,2,2
1,Main,Corki,20,71.4,5,15,8,8,7
1,Main,Jarvan IV,20,71.4,7,13,5,8,5
1,Main,Vayne,20,71.4,12,8,5,4,4
1,Main,Janna,19,67.9,1,18,6,10,8
1,Main,Ashe,19,67.9,2,17,8,13,4
1,Main,Nidalee,19,67.9,15,4,3,3,1
1,Main,Sona,18,64.3,3,15,6,9,6
1,Main,Amumu,18,64.3,8,10,6,3,7
1,Main,Malzahar,16,57.1,,16,6,9,7
1,Main,Warwick,14,50,3,11,7,6,5
1,Main,Anivia,14,50,5,9,4,5,4
1,Main,Taric,13,46.4,3,10,6,3,7
1,Main,Annie,10,35.7,2,8,5,4,4
1,Main,Karthus,9,32.1,3,6,4,2,4
1,Main,Brand,8,28.6,,8,3,3,5
1,Main,Miss Fortune,8,28.6,,8,4,2,6
1,Main,Soraka,8,28.6,1,7,5,2,5
1,Main,Gragas,7,25,3,4,3,3,1
1,Main,Nocturne,7,25,3,4,3,2,2
1,Main,Irelia,7,25,3,4,2,1,3
1,Main,Zilean,7,25,5,2,2,1,1
1,Main,Akali,7,25,6,1,1,1,0
1,Main,Singed,6,21.4,2,4,2,2,2
1,Main,Swain,5,17.9,,5,4,2,3
1,Main,Caitlyn,4,14.3,,4,3,0,4
1,Main,Cho'Gath,3,10.7,,3,3,1,2
1,Main,Tristana,3,10.7,,3,2,1,2
1,Main,Trundle,3,10.7,,3,3,0,3
1,Main,Mordekaiser,3,10.7,2,1,1,1,0
1,Main,Lee Sin,2,7.1,,2,2,1,1
1,Main,Teemo,2,7.1,,2,1,1,1
1,Main,Gangplank,1,3.6,,1,1,1,0
1,Main,Sion,1,3.6,,1,1,1,0
1,Main,Blitzcrank,1,3.6,,1,1,0,1
1,Main,Dr. Mundo,1,3.6,,1,1,0,1
1,Main,Garen,1,3.6,,1,1,0,1
1,Main,Kassadin,1,3.6,,1,1,0,1
1,Main,Lux,1,3.6,,1,1,0,1
1,Main,Poppy,1,3.6,,1,1,0,1
1,Main,Rammus,1,3.6,,1,1,0,1
1,Main,Urgot,1,3.6,,1,1,0,1
2,Main,Ezreal,28,90.3,4,24,10,11,13
2,Main,Jayce,26,83.9,14,12,7,7,5
2,Main,Shen,24,77.4,6,18,9,7,11
2,Main,Sona,23,74.2,7,16,7,12,4
2,Main,Orianna,22,71,13,9,5,8,1
2,Main,Karthus,21,67.7,5,16,6,7,9
2,Main,Maokai,21,67.7,6,15,6,9,6
2,Main,Skarner,21,67.7,12,9,5,7,2
2,Main,Anivia,19,61.3,12,7,3,4,3
2,Main,Alistar,19,61.3,14,5,3,2,3
2,Main,Irelia,17,54.8,9,8,6,4,4
2,Main,Blitzcrank,17,54.8,12,5,5,3,2
2,Main,Kog'Maw,14,45.2,4,10,3,6,4
2,Main,Vladimir,14,45.2,5,9,5,5,4
2,Main,Evelynn,14,45.2,12,2,1,2,0
2,Main,Nunu,13,41.9,2,11,6,5,6
2,Main,Yorick,11,35.5,5,6,3,2,4
2,Main,Corki,10,32.3,,10,7,5,5
2,Main,Jax,10,32.3,5,5,3,3,2
2,Main,Dr. Mundo,7,22.6,,7,2,5,2
2,Main,Graves,7,22.6,,7,4,3,4
2,Main,Leona,7,22.6,,7,5,2,5
2,Main,Olaf,7,22.6,2,5,4,2,3
2,Main,Lee Sin,7,22.6,4,3,2,3,0
2,Main,Nidalee,7,22.6,4,3,2,3,0
2,Main,Twisted Fate,7,22.6,7,0,,0,0
2,Main,Taric,6,19.4,,6,5,2,4
2,Main,Lulu,6,19.4,,6,4,1,5
2,Main,Lux,6,19.4,1,5,4,2,3
2,Main,Shyvana,6,19.4,1,5,5,0,5
2,Main,Malphite,6,19.4,2,4,3,2,2
2,Main,Diana,6,19.4,3,3,2,1,2
2,Main,Udyr,5,16.1,,5,4,0,5
2,Main,Morgana,5,16.1,1,4,3,1,3
2,Main,Vayne,4,12.9,,4,2,3,1
2,Main,Zyra,4,12.9,,4,2,2,2
2,Main,Cassiopeia,4,12.9,,4,2,1,3
2,Main,Gragas,4,12.9,2,2,2,0,2
2,Main,Katarina,4,12.9,3,1,1,0,1
2,Main,Miss Fortune,3,9.7,,3,1,2,1
2,Main,Caitlyn,3,9.7,,3,3,1,2
2,Main,Ryze,3,9.7,,3,2,1,2
2,Main,Cho'Gath,3,9.7,1,2,2,1,1
2,Main,Sivir,3,9.7,3,0,,0,0
2,Main,Singed,2,6.5,,2,1,2,0
2,Main,Xin Zhao,2,6.5,,2,2,2,0
2,Main,Zilean,2,6.5,,2,1,1,1
2,Main,Darius,2,6.5,,2,2,0,2
2,Main,Nocturne,2,6.5,,2,2,0,2
2,Main,Ahri,2,6.5,1,1,1,1,0
2,Main,Draven,2,6.5,2,0,,0,0
2,Main,Amumu,1,3.2,,1,1,1,0
2,Main,Soraka,1,3.2,,1,1,1,0
2,Main,Jarvan IV,1,3.2,,1,1,0,1
2,Main,Riven,1,3.2,,1,1,0,1
2,Main,Swain,1,3.2,,1,1,0,1
2,Main,Tristana,1,3.2,,1,1,0,1
2,Main,Gangplank,1,3.2,1,0,,0,0
2,Main,Twitch,1,3.2,1,0,,0,0
3,Main,Zed,63,100,52,11,9,6,5
3,Main,Shen,61,96.8,35,26,13,15,11
3,Main,Corki,59,93.7,26,33,12,16,17
3,Main,Ahri,52,82.5,26,26,10,12,14
3,Main,Zyra,48,76.2,6,42,12,23,19
3,Main,Elise,48,76.2,11,37,16,16,21
3,Main,Sona,44,69.8,8,36,12,13,23
3,Main,Orianna,41,65.1,20,21,10,12,9
3,Main,Lee Sin,40,63.5,14,26,10,16,10
3,Main,Thresh,40,63.5,22,18,9,9,9
3,Main,Aatrox,36,57.1,16,20,8,12,8
3,Main,Fizz,34,54,22,12,9,6,6
3,Main,Renekton,32,50.8,11,21,8,14,7
3,Main,Caitlyn,32,50.8,12,20,9,12,8
3,Main,Vi,30,47.6,17,13,5,7,6
3,Main,Jarvan IV,26,41.3,1,25,11,11,14
3,Main,Ezreal,22,34.9,,22,12,11,11
3,Main,Vayne,22,34.9,6,16,7,8,8
3,Main,Kassadin,19,30.2,12,7,5,5,2
3,Main,Gragas,18,28.6,2,16,9,7,9
3,Main,Zac,17,27,2,15,6,7,8
3,Main,Varus,15,23.8,,15,8,6,9
3,Main,Kennen,15,23.8,9,6,5,2,4
3,Main,Jax,14,22.2,4,10,4,7,3
3,Main,Annie,12,19,7,5,4,3,2
3,Main,Leona,11,17.5,1,10,4,7,3
3,Main,Twisted Fate,11,17.5,5,6,4,2,4
3,Main,Evelynn,11,17.5,7,4,2,3,1
3,Main,Rumble,10,15.9,2,8,5,2,6
3,Main,Lissandra,10,15.9,4,6,5,3,3
3,Main,Kog'Maw,8,12.7,1,7,3,5,2
3,Main,Fiddlesticks,8,12.7,2,6,5,4,2
3,Main,Twitch,8,12.7,5,3,2,1,2
3,Main,Ashe,7,11.1,1,6,3,3,3
3,Main,Nocturne,7,11.1,2,5,3,1,4
3,Main,Vladimir,6,9.5,,6,5,2,4
3,Main,Singed,6,9.5,1,5,3,3,2
3,Main,Lulu,5,7.9,,5,4,1,4
3,Main,Ryze,5,7.9,,5,2,1,4
3,Main,Karthus,5,7.9,2,3,3,1,2
3,Main,Nasus,4,6.3,,4,3,2,2
3,Main,Nidalee,3,4.8,,3,3,2,1
3,Main,Diana,3,4.8,,3,3,1,2
3,Main,Nunu,3,4.8,,3,2,1,2
3,Main,Tristana,3,4.8,,3,3,1,2
3,Main,Malphite,3,4.8,,3,3,0,3
3,Main,Yorick,3,4.8,1,2,2,1,1
3,Main,Riven,2,3.2,,2,1,2,0
3,Main,Nami,2,3.2,,2,1,1,1
3,Main,Syndra,2,3.2,,2,1,1,1
3,Main,Shyvana,2,3.2,,2,2,0,2
3,Main,Blitzcrank,1,1.6,,1,1,1,0
3,Main,Cassiopeia,1,1.6,,1,1,1,0
3,Main,Jayce,1,1.6,,1,1,1,0
3,Main,Kayle,1,1.6,,1,1,1,0
3,Main,Sivir,1,1.6,,1,1,1,0
3,Main,Tryndamere,1,1.6,,1,1,1,0
3,Main,Veigar,1,1.6,,1,1,1,0
3,Main,Volibear,1,1.6,,1,1,1,0
3,Main,Dr. Mundo,1,1.6,,1,1,0,1
3,Main,Hecarim,1,1.6,,1,1,0,1
3,Main,Karma,1,1.6,,1,1,0,1
3,Main,Miss Fortune,1,1.6,,1,1,0,1
3,Main,Soraka,1,1.6,,1,1,0,1
3,Main,Swain,1,1.6,,1,1,0,1
3,Main,Teemo,1,1.6,,1,1,0,1
3,Main,Xin Zhao,1,1.6,,1,1,0,1
3,Main,Zilean,1,1.6,,1,1,0,1
3,Main,Ziggs,1,1.6,1,0,,0,0
4,Main,Alistar,78,100,73,5,5,4,1
4,Main,Zilean,75,96.2,62,13,11,6,7
4,Main,Lee Sin,72,92.3,29,43,16,24,19
4,Main,Maokai,72,92.3,45,27,12,17,10
4,Main,Ryze,68,87.2,31,37,14,22,15
4,Main,Kha'Zix,66,84.6,8,58,18,25,33
4,Main,Thresh,63,80.8,19,44,15,24,20
4,Main,Lucian,61,78.2,17,44,15,23,21
4,Main,Janna,53,67.9,8,45,14,28,17
4,Main,Rumble,40,51.3,15,25,11,13,12
4,Main,Tristana,39,50,7,32,15,12,20
4,Main,Zed,38,48.7,19,19,9,9,10
4,Main,Twitch,35,44.9,11,24,9,17,7
4,Main,Rengar,33,42.3,19,14,6,12,2
4,Main,Orianna,32,41,5,27,12,14,13
4,Main,Yasuo,30,38.5,15,15,8,10,5
4,Main,Nami,29,37.2,3,26,12,10,16
4,Main,Syndra,25,32.1,11,14,9,5,9
4,Main,Nidalee,25,32.1,17,8,6,1,7
4,Main,Fizz,24,30.8,11,13,7,5,8
4,Main,Corki,22,28.2,,22,7,12,10
4,Main,Irelia,21,26.9,6,15,7,10,5
4,Main,Jayce,20,25.6,8,12,6,7,5
4,Main,Jarvan IV,18,23.1,1,17,10,6,11
4,Main,Kog'Maw,17,21.8,1,16,9,7,9
4,Main,Lulu,17,21.8,2,15,10,5,10
4,Main,Elise,16,20.5,1,15,9,5,10
4,Main,Kayle,15,19.2,2,13,10,5,8
4,Main,Twisted Fate,14,17.9,6,8,4,3,5
4,Main,Ahri,13,16.7,1,12,8,5,7
4,Main,Braum,12,15.4,,12,9,6,6
4,Main,Morgana,12,15.4,,12,6,6,6
4,Main,Dr. Mundo,10,12.8,,10,5,1,9
4,Main,Kassadin,10,12.8,2,8,6,5,3
4,Main,Jinx,10,12.8,3,7,3,2,5
4,Main,Talon,7,9,,7,4,3,4
4,Main,Xerath,6,7.7,,6,6,2,4
4,Main,Aatrox,6,7.7,6,0,,0,0
4,Main,Vayne,4,5.1,,4,3,3,1
4,Main,Leona,3,3.8,,3,2,1,2
4,Main,Pantheon,3,3.8,,3,2,1,2
4,Main,Blitzcrank,3,3.8,,3,1,0,3
4,Main,Sona,3,3.8,,3,2,0,3
4,Main,Rammus,3,3.8,1,2,2,2,0
4,Main,Evelynn,2,2.6,,2,2,2,0
4,Main,Caitlyn,2,2.6,,2,1,1,1
4,Main,Graves,2,2.6,,2,2,1,1
4,Main,Singed,2,2.6,,2,1,1,1
4,Main,Ziggs,2,2.6,,2,2,1,1
4,Main,Ezreal,2,2.6,,2,2,0,2
4,Main,Akali,1,1.3,,1,1,1,0
4,Main,Fiddlesticks,1,1.3,,1,1,1,0
4,Main,Katarina,1,1.3,,1,1,1,0
4,Main,Lissandra,1,1.3,,1,1,1,0
4,Main,Riven,1,1.3,,1,1,1,0
4,Main,Swain,1,1.3,,1,1,1,0
4,Main,Galio,1,1.3,,1,1,0,1
4,Main,Nunu,1,1.3,,1,1,0,1
4,Main,Varus,1,1.3,,1,1,0,1
4,Main,Vi,1,1.3,,1,1,0,1
4,Main,Gragas,1,1.3,1,0,,0,0
5,Main,Gangplank,73,100,69,4,4,4,0
5,Main,Mordekaiser,72,98.6,68,4,4,4,0
5,Main,Elise,71,97.3,32,39,14,26,13
5,Main,Lulu,69,94.5,43,26,16,13,13
5,Main,Rek'Sai,56,76.7,19,37,10,15,22
5,Main,Kalista,54,74,25,29,13,14,15
5,Main,Darius,53,72.6,15,38,16,19,19
5,Main,Azir,42,57.5,28,14,8,10,4
5,Main,Thresh,35,47.9,6,29,14,13,16
5,Main,Tahm Kench,34,46.6,20,14,7,10,4
5,Main,Alistar,33,45.2,3,30,11,15,15
5,Main,Jinx,33,45.2,4,29,13,15,14
5,Main,Gragas,33,45.2,4,29,12,13,16
5,Main,Lee Sin,28,38.4,10,18,7,9,9
5,Main,Twisted Fate,28,38.4,16,12,8,7,5
5,Main,Tristana,27,37,,27,11,11,16
5,Main,Braum,24,32.9,3,21,14,8,13
5,Main,Fiora,23,31.5,4,19,6,11,8
5,Main,Gnar,21,28.8,2,19,12,8,11
5,Main,Kennen,21,28.8,5,16,10,8,8
5,Main,Morgana,20,27.4,2,18,8,8,10
5,Main,Sivir,19,26,,19,8,9,10
5,Main,Viktor,18,24.7,1,17,8,8,9
5,Main,Veigar,18,24.7,10,8,5,3,5
5,Main,LeBlanc,17,23.3,6,11,6,6,5
5,Main,Shen,15,20.5,3,12,5,10,2
5,Main,Malphite,14,19.2,4,10,7,3,7
5,Main,Ashe,13,17.8,4,9,3,5,4
5,Main,Orianna,12,16.4,,12,6,3,9
5,Main,Olaf,12,16.4,2,10,7,4,6
5,Main,Yasuo,12,16.4,6,6,6,2,4
5,Main,Riven,10,13.7,,10,5,5,5
5,Main,Annie,10,13.7,1,9,7,4,5
5,Main,Renekton,10,13.7,4,6,3,4,2
5,Main,Ekko,9,12.3,,9,9,3,6
5,Main,Fizz,9,12.3,5,4,1,2,2
5,Main,Kog'Maw,8,11,1,7,4,3,4
5,Main,Ryze,8,11,2,6,2,5,1
5,Main,Kassadin,7,9.6,,7,3,5,2
5,Main,Vayne,7,9.6,1,6,5,2,4
5,Main,Anivia,6,8.2,,6,2,4,2
5,Main,Rumble,6,8.2,1,5,1,4,1
5,Main,Diana,6,8.2,2,4,3,2,2
5,Main,Nidalee,6,8.2,3,3,3,3,0
5,Main,Varus,6,8.2,4,2,2,1,1
5,Main,Jarvan IV,5,6.8,,5,3,4,1
5,Main,Caitlyn,5,6.8,,5,3,3,2
5,Main,Hecarim,5,6.8,,5,4,2,3
5,Main,Lissandra,4,5.5,,4,4,2,2
5,Main,Evelynn,4,5.5,,4,3,1,3
5,Main,Janna,3,4.1,,3,3,2,1
5,Main,Ahri,3,4.1,,3,3,1,2
5,Main,Skarner,3,4.1,,3,3,1,2
5,Main,Maokai,3,4.1,,3,2,0,3
5,Main,Zac,2,2.7,,2,1,2,0
5,Main,Bard,2,2.7,,2,2,0,2
5,Main,Irelia,2,2.7,,2,2,0,2
5,Main,Rengar,2,2.7,,2,2,0,2
5,Main,Zed,2,2.7,,2,2,0,2
5,Main,Draven,1,1.4,,1,1,1,0
5,Main,Graves,1,1.4,,1,1,1,0
5,Main,Karthus,1,1.4,,1,1,1,0
5,Main,Leona,1,1.4,,1,1,1,0
5,Main,Lucian,1,1.4,,1,1,1,0
5,Main,Vladimir,1,1.4,,1,1,1,0
5,Main,Blitzcrank,1,1.4,,1,1,0,1
5,Main,Brand,1,1.4,,1,1,0,1
5,Main,Cassiopeia,1,1.4,,1,1,0,1
5,Main,Jayce,1,1.4,,1,1,0,1
5,Main,Nautilus,1,1.4,,1,1,0,1
5,Main,Nunu,1,1.4,,1,1,0,1
5,Main,Syndra,1,1.4,,1,1,0,1
5,Main,Twitch,1,1.4,,1,1,0,1
5,Main,Vi,1,1.4,,1,1,0,1
6,Main,Nidalee,77,100,66,11,10,8,3
6,Main,Syndra,75,97.4,59,16,10,10,6
6,Main,Olaf,59,76.6,23,36,14,18,18
6,Main,Karma,58,75.3,16,42,16,19,23
6,Main,Jhin,51,66.2,12,39,13,24,15
6,Main,Elise,50,64.9,21,29,15,10,19
6,Main,Caitlyn,49,63.6,15,34,11,16,18
6,Main,Jayce,47,61,21,26,15,15,11
6,Main,Ryze,46,59.7,27,19,11,10,9
6,Main,Lee Sin,45,58.4,8,37,13,21,16
6,Main,Rumble,41,53.2,9,32,13,16,16
6,Main,Ezreal,39,50.6,7,32,12,11,21
6,Main,Poppy,38,49.4,9,29,11,14,15
6,Main,Kennen,37,48.1,14,23,12,12,11
6,Main,Rek'Sai,34,44.2,16,18,12,8,10
6,Main,Aurelion Sol,32,41.6,20,12,10,8,4
6,Main,Sivir,31,40.3,11,20,11,10,10
6,Main,Gnar,30,39,12,18,12,7,11
6,Main,Viktor,29,37.7,6,23,8,13,10
6,Main,Alistar,28,36.4,5,23,16,15,8
6,Main,Cassiopeia,28,36.4,6,22,10,8,14
6,Main,Zyra,27,35.1,5,22,5,14,8
6,Main,Vladimir,27,35.1,12,15,9,7,8
6,Main,Nami,26,33.8,2,24,12,10,14
6,Main,Tahm Kench,23,29.9,12,11,7,6,5
6,Main,Bard,17,22.1,5,12,5,3,9
6,Main,Braum,16,20.8,,16,12,6,10
6,Main,Ashe,15,19.5,4,11,5,7,4
6,Main,Lucian,14,18.2,1,13,7,7,6
6,Main,Malzahar,14,18.2,3,11,8,5,6
6,Main,Orianna,13,16.9,,13,6,5,8
6,Main,Trundle,12,15.6,1,11,6,6,5
6,Main,Ekko,11,14.3,1,10,5,5,5
6,Main,Brand,9,11.7,8,1,1,1,0
6,Main,Varus,8,10.4,3,5,4,3,2
6,Main,Zac,8,10.4,4,4,3,2,2
6,Main,Graves,7,9.1,,7,5,3,4
6,Main,Skarner,7,9.1,1,6,5,4,2
6,Main,Miss Fortune,7,9.1,4,3,2,3,0
6,Main,Irelia,6,7.8,1,5,4,3,2
6,Main,Twisted Fate,6,7.8,5,1,1,0,1
6,Main,Jinx,5,6.5,,5,3,2,3
6,Main,Zilean,4,5.2,,4,4,1,3
6,Main,Kassadin,4,5.2,4,0,,0,0
6,Main,Hecarim,3,3.9,,3,2,2,1
6,Main,Lissandra,3,3.9,,3,2,2,1
6,Main,Soraka,3,3.9,1,2,2,1,1
6,Main,Maokai,2,2.6,,2,2,1,1
6,Main,Anivia,2,2.6,1,1,1,1,0
6,Main,Shen,2,2.6,1,1,1,0,1
6,Main,Nocturne,1,1.3,,1,1,1,0
6,Main,Taric,1,1.3,,1,1,1,0
6,Main,Fiora,1,1.3,,1,1,0,1
6,Main,Kha'Zix,1,1.3,,1,1,0,1
6,Main,Kindred,1,1.3,,1,1,0,1
6,Main,Kled,1,1.3,,1,1,0,1
6,Main,Nautilus,1,1.3,,1,1,0,1
7,Play in,Kalista,39,100,34,5,4,4,1
7,Play in,Sejuani,38,97.4,22,16,11,7,9
7,Play in,Jarvan IV,37,94.9,24,13,9,8,5
7,Play in,Galio,35,89.7,17,18,13,13,5
7,Play in,Syndra,33,84.6,16,17,8,8,9
7,Play in,Tristana,32,82.1,8,24,10,12,12
7,Play in,Rakan,30,76.9,17,13,7,9,4
7,Play in,Xayah,29,74.4,9,20,10,10,10
7,Play in,Cho'Gath,28,71.8,13,15,10,6,9
7,Play in,Gragas,26,66.7,3,23,10,14,9
7,Play in,Alistar,25,64.1,14,11,8,3,8
7,Play in,Maokai,24,61.5,8,16,8,10,6
7,Play in,Shen,23,59,13,10,7,4,6
7,Play in,Orianna,22,56.4,12,10,8,4,6
7,Play in,Rek'Sai,20,51.3,12,8,5,4,4
7,Play in,Janna,19,48.7,5,14,6,12,2
7,Play in,Lulu,19,48.7,5,14,7,5,9
7,Play in,Kog'Maw,19,48.7,10,9,7,4,5
7,Play in,Corki,18,46.2,7,11,6,4,7
7,Play in,LeBlanc,18,46.2,13,5,5,3,2
7,Play in,Taliyah,17,43.6,13,4,4,3,1
7,Play in,Braum,15,38.5,6,9,5,3,6
7,Play in,Jayce,15,38.5,10,5,3,3,2
7,Play in,Thresh,15,38.5,13,2,2,1,1
7,Play in,Varus,14,35.9,4,10,7,4,6
7,Play in,Elise,11,28.2,8,3,3,0,3
7,Play in,Ryze,10,25.6,7,3,3,2,1
7,Play in,Cassiopeia,9,23.1,3,6,5,4,2
7,Play in,Rumble,9,23.1,3,6,4,3,3
7,Play in,Lucian,9,23.1,7,2,2,0,2
7,Play in,Karma,8,20.5,3,5,5,2,3
7,Play in,Nidalee,8,20.5,4,4,4,2,2
7,Play in,Kassadin,8,20.5,6,2,2,1,1
7,Play in,Gnar,7,17.9,3,4,4,2,2
7,Play in,Lee Sin,6,15.4,1,5,3,1,4
7,Play in,Morgana,6,15.4,2,4,3,2,2
7,Play in,Jax,6,15.4,3,3,3,1,2
7,Play in,Aurelion Sol,6,15.4,4,2,2,2,0
7,Play in,Olaf,6,15.4,4,2,1,1,1
7,Play in,Ezreal,5,12.8,1,4,3,3,1
7,Play in,Camille,5,12.8,1,4,3,2,2
7,Play in,Trundle,5,12.8,5,0,,0,0
7,Play in,Blitzcrank,4,10.3,3,1,1,0,1
7,Play in,Kayn,4,10.3,3,1,1,0,1
7,Play in,Taric,3,7.7,,3,3,2,1
7,Play in,Twitch,3,7.7,1,2,2,2,0
7,Play in,Anivia,3,7.7,2,1,1,0,1
7,Play in,Dr. Mundo,3,7.7,3,0,,0,0
7,Play in,Ashe,2,5.1,,2,1,1,1
7,Play in,Sivir,2,5.1,,2,2,1,1
7,Play in,Fiora,2,5.1,,2,2,0,2
7,Play in,Vladimir,2,5.1,,2,2,0,2
7,Play in,Caitlyn,2,5.1,1,1,1,0,1
7,Play in,Renekton,2,5.1,1,1,1,0,1
7,Play in,Zac,2,5.1,1,1,1,0,1
7,Play in,Ekko,1,2.6,,1,1,1,0
7,Play in,Graves,1,2.6,,1,1,1,0
7,Play in,Vayne,1,2.6,,1,1,1,0
7,Play in,Draven,1,2.6,,1,1,0,1
7,Play in,Jhin,1,2.6,,1,1,0,1
7,Play in,Kha'Zix,1,2.6,,1,1,0,1
7,Play in,Malzahar,1,2.6,,1,1,0,1
7,Play in,Nunu,1,2.6,,1,1,0,1
7,Play in,Soraka,1,2.6,,1,1,0,1
7,Play in,Yasuo,1,2.6,,1,1,0,1
7,Play in,Amumu,1,2.6,1,0,,0,0
7,Play in,Brand,1,2.6,1,0,,0,0
7,Main,Kalista,80,100,80,0,,0,0
7,Main,Sejuani,79,98.8,35,44,17,22,22
7,Main,Jarvan IV,79,98.8,37,42,16,22,20
7,Main,Janna,76,95,32,44,14,31,13
7,Main,Lulu,75,93.8,28,47,17,19,28
7,Main,Galio,73,91.3,52,21,10,14,7
7,Main,Xayah,69,86.3,44,25,13,13,12
7,Main,Cho'Gath,62,77.5,21,41,17,21,20
7,Main,Tristana,61,76.3,16,45,15,22,23
7,Main,Gragas,58,72.5,22,36,15,23,13
7,Main,Rakan,54,67.5,34,20,12,11,9
7,Main,Syndra,51,63.7,28,23,13,10,13
7,Main,Shen,51,63.7,29,22,11,11,11
7,Main,Kog'Maw,49,61.3,22,27,14,12,15
7,Main,Jayce,47,58.8,36,11,7,7,4
7,Main,Ryze,43,53.8,15,28,13,9,19
7,Main,Gnar,41,51.2,25,16,9,12,4
7,Main,Taliyah,40,50,24,16,8,9,7
7,Main,Maokai,32,40,6,26,14,7,19
7,Main,Orianna,32,40,19,13,8,6,7
7,Main,Twitch,31,38.8,9,22,9,13,9
7,Main,Varus,29,36.3,6,23,9,10,13
7,Main,Cassiopeia,29,36.3,20,9,6,4,5
7,Main,LeBlanc,27,33.8,23,4,4,3,1
7,Main,Trundle,22,27.5,11,11,9,6,5
7,Main,Ezreal,22,27.5,16,6,3,2,4
7,Main,Taric,20,25,2,18,8,7,11
7,Main,Corki,19,23.8,3,16,10,7,9
7,Main,Caitlyn,19,23.8,10,9,4,6,3
7,Main,Rek'Sai,18,22.5,7,11,7,4,7
7,Main,Malzahar,17,21.3,7,10,3,9,1
7,Main,Lucian,17,21.3,12,5,3,1,4
7,Main,Rumble,15,18.8,8,7,4,3,4
7,Main,Karma,14,17.5,3,11,8,3,8
7,Main,Kassadin,14,17.5,10,4,4,2,2
7,Main,Renekton,9,11.3,6,3,3,1,2
7,Main,Kha'Zix,7,8.8,4,3,2,3,0
7,Main,Thresh,7,8.8,4,3,2,1,2
7,Main,Blitzcrank,6,7.5,3,3,2,1,2
7,Main,Soraka,5,6.3,1,4,1,3,1
7,Main,Kennen,5,6.3,1,4,2,2,2
7,Main,Vayne,5,6.3,1,4,3,2,2
7,Main,Zac,5,6.3,1,4,3,1,3
7,Main,Ivern,5,6.3,3,2,2,1,1
7,Main,Fizz,4,5,,4,2,3,1
7,Main,Lee Sin,4,5,,4,3,2,2
7,Main,Leona,4,5,1,3,2,2,1
7,Main,Kayn,4,5,1,3,1,1,2
7,Main,Sivir,4,5,1,3,2,1,2
7,Main,Singed,4,5,2,2,1,2,0
7,Main,Elise,4,5,2,2,1,1,1
7,Main,Nocturne,4,5,2,2,2,1,1
7,Main,Alistar,4,5,2,2,2,0,2
7,Main,Nidalee,4,5,3,1,1,0,1
7,Main,Nautilus,3,3.8,,3,2,2,1
7,Main,Camille,3,3.8,,3,2,1,2
7,Main,Yasuo,3,3.8,,3,3,1,2
7,Main,Graves,3,3.8,1,2,1,1,1
7,Main,Urgot,3,3.8,1,2,1,1,1
7,Main,Morgana,2,2.5,,2,2,0,2
7,Main,Braum,2,2.5,1,1,1,1,0
7,Main,Nasus,2,2.5,1,1,1,1,0
7,Main,Jax,2,2.5,1,1,1,0,1
7,Main,Vladimir,2,2.5,1,1,1,0,1
7,Main,Sion,2,2.5,2,0,,0,0
7,Main,Ashe,1,1.3,,1,1,1,0
7,Main,Lissandra,1,1.3,,1,1,1,0
7,Main,Tahm Kench,1,1.3,,1,1,1,0
7,Main,Aurelion Sol,1,1.3,,1,1,0,1
7,Main,Ekko,1,1.3,,1,1,0,1
7,Main,Gangplank,1,1.3,,1,1,0,1
7,Main,Jinx,1,1.3,,1,1,0,1
7,Main,Mordekaiser,1,1.3,,1,1,0,1
7,Main,Nami,1,1.3,,1,1,0,1
7,Main,Rengar,1,1.3,,1,1,0,1
7,Main,Sona,1,1.3,,1,1,0,1
7,Main,Zilean,1,1.3,,1,1,0,1
7,Main,Bard,1,1.3,1,0,,0,0
7,Main,Twisted Fate,1,1.3,1,0,,0,0
8,Play in,Urgot,42,100,23,19,12,13,6
8,Play in,Aatrox,42,100,31,11,8,3,8
8,Play in,Alistar,38,90.5,16,22,12,13,9
8,Play in,Akali,33,78.6,25,8,6,3,5
8,Play in,Kai'Sa,32,76.2,6,26,9,18,8
8,Play in,Gragas,31,73.8,14,17,11,7,10
8,Play in,Rakan,31,73.8,18,13,8,7,6
8,Play in,Tahm Kench,30,71.4,17,13,10,6,7
8,Play in,Skarner,27,64.3,15,12,8,7,5
8,Play in,Olaf,27,64.3,18,9,6,3,6
8,Play in,Ryze,26,61.9,16,10,7,8,2
8,Play in,LeBlanc,25,59.5,15,10,8,6,4
8,Play in,Ornn,24,57.1,11,13,8,6,7
8,Play in,Varus,24,57.1,15,9,6,5,4
8,Play in,Irelia,23,54.8,17,6,5,5,1
8,Play in,Nocturne,22,52.4,10,12,8,6,6
8,Play in,Sion,21,50,6,15,7,6,9
8,Play in,Syndra,19,45.2,9,10,6,4,6
8,Play in,Camille,19,45.2,11,8,6,3,5
8,Play in,Heimerdinger,17,40.5,14,3,1,0,3
8,Play in,Xayah,16,38.1,6,10,7,5,5
8,Play in,Galio,16,38.1,10,6,4,3,3
8,Play in,Lucian,15,35.7,4,11,5,2,9
8,Play in,Braum,15,35.7,5,10,8,4,6
8,Play in,Kindred,13,31,6,7,4,4,3
8,Play in,Thresh,12,28.6,4,8,5,4,4
8,Play in,Lissandra,12,28.6,8,4,3,3,1
8,Play in,Tristana,11,26.2,1,10,8,4,6
8,Play in,Taliyah,11,26.2,3,8,4,6,2
8,Play in,Xin Zhao,10,23.8,4,6,5,3,3
8,Play in,Shen,9,21.4,3,6,5,4,2
8,Play in,Poppy,8,19,3,5,4,4,1
8,Play in,Ziggs,7,16.7,6,1,1,0,1
8,Play in,Leona,6,14.3,2,4,4,2,2
8,Play in,Cassiopeia,6,14.3,2,4,4,0,4
8,Play in,Morgana,6,14.3,3,3,2,2,1
8,Play in,Zoe,6,14.3,5,1,1,0,1
8,Play in,Malzahar,5,11.9,1,4,3,1,3
8,Play in,Pyke,5,11.9,3,2,2,0,2
8,Play in,Anivia,5,11.9,4,1,1,1,0
8,Play in,Zilean,5,11.9,4,1,1,1,0
8,Play in,Draven,4,9.5,,4,2,2,2
8,Play in,Orianna,4,9.5,,4,3,2,2
8,Play in,Ezreal,4,9.5,,4,2,1,3
8,Play in,Jhin,4,9.5,1,3,1,3,0
8,Play in,Trundle,4,9.5,1,3,3,0,3
8,Play in,Azir,4,9.5,2,2,2,2,0
8,Play in,Lee Sin,4,9.5,2,2,2,1,1
8,Play in,Vel'Koz,4,9.5,3,1,1,1,0
8,Play in,Yasuo,4,9.5,3,1,1,1,0
8,Play in,Maokai,3,7.1,,3,2,2,1
8,Play in,Jarvan IV,3,7.1,,3,3,1,2
8,Play in,Kassadin,3,7.1,,3,3,1,2
8,Play in,Karma,3,7.1,1,2,1,2,0
8,Play in,Cho'Gath,3,7.1,1,2,2,1,1
8,Play in,Darius,3,7.1,2,1,1,1,0
8,Play in,Singed,3,7.1,2,1,1,1,0
8,Play in,Nautilus,2,4.8,,2,2,2,0
8,Play in,Graves,2,4.8,,2,2,1,1
8,Play in,Vayne,2,4.8,,2,2,0,2
8,Play in,Viktor,2,4.8,,2,2,0,2
8,Play in,Ashe,2,4.8,1,1,1,0,1
8,Play in,Gnar,2,4.8,1,1,1,0,1
8,Play in,Sejuani,2,4.8,1,1,1,0,1
8,Play in,Gangplank,1,2.4,,1,1,1,0
8,Play in,Kalista,1,2.4,,1,1,1,0
8,Play in,Zac,1,2.4,,1,1,1,0
8,Play in,Ahri,1,2.4,,1,1,0,1
8,Play in,Caitlyn,1,2.4,,1,1,0,1
8,Play in,Corki,1,2.4,,1,1,0,1
8,Play in,Fiora,1,2.4,,1,1,0,1
8,Play in,Kog'Maw,1,2.4,,1,1,0,1
8,Play in,Lulu,1,2.4,,1,1,0,1
8,Play in,Nidalee,1,2.4,,1,1,0,1
8,Play in,Soraka,1,2.4,,1,1,0,1
8,Play in,Taric,1,2.4,,1,1,0,1
8,Play in,Hecarim,1,2.4,1,0,,0,0
8,Play in,Janna,1,2.4,1,0,,0,0
8,Play in,Jax,1,2.4,1,0,,0,0
8,Play in,Sivir,1,2.4,1,0,,0,0
8,Play in,Zed,1,2.4,1,0,,0,0
8,Main,Aatrox,76,98.7,45,31,17,17,14
8,Main,Alistar,75,97.4,47,28,12,15,13
8,Main,Urgot,73,94.8,45,28,17,13,15
8,Main,Irelia,64,83.1,40,24,13,14,10
8,Main,Kai'Sa,62,80.5,19,43,15,21,22
8,Main,Xayah,62,80.5,28,34,15,17,17
8,Main,Akali,62,80.5,51,11,8,8,3
8,Main,Rakan,56,72.7,25,31,13,17,14
8,Main,Nocturne,53,68.8,31,22,13,15,7
8,Main,LeBlanc,51,66.2,34,17,10,12,5
8,Main,Tahm Kench,50,64.9,34,16,10,7,9
8,Main,Sion,44,57.1,15,29,15,13,16
8,Main,Xin Zhao,44,57.1,19,25,12,14,11
8,Main,Lissandra,43,55.8,21,22,10,7,15
8,Main,Taliyah,42,54.5,25,17,10,10,7
8,Main,Camille,42,54.5,25,17,9,8,9
8,Main,Gragas,41,53.2,9,32,18,13,19
8,Main,Syndra,40,51.9,21,19,12,9,10
8,Main,Galio,38,49.4,17,21,10,10,11
8,Main,Thresh,36,46.8,15,21,11,9,12
8,Main,Ryze,34,44.2,17,17,13,8,9
8,Main,Braum,30,39,6,24,9,13,11
8,Main,Shen,28,36.4,12,16,9,9,7
8,Main,Sivir,27,35.1,9,18,7,12,6
8,Main,Olaf,27,35.1,11,16,13,7,9
8,Main,Ornn,25,32.5,13,12,8,10,2
8,Main,Lee Sin,24,31.2,7,17,7,9,8
8,Main,Lucian,23,29.9,8,15,6,9,6
8,Main,Kindred,23,29.9,17,6,4,2,4
8,Main,Varus,22,28.6,11,11,8,5,6
8,Main,Swain,19,24.7,8,11,6,5,6
8,Main,Heimerdinger,15,19.5,13,2,1,2,0
8,Main,Tristana,14,18.2,5,9,7,4,5
8,Main,Leona,13,16.9,2,11,8,7,4
8,Main,Viktor,13,16.9,6,7,4,3,4
8,Main,Jayce,13,16.9,8,5,5,3,2
8,Main,Poppy,11,14.3,3,8,7,2,6
8,Main,Jhin,11,14.3,5,6,2,2,4
8,Main,Skarner,11,14.3,8,3,3,0,3
8,Main,Ezreal,9,11.7,1,8,4,3,5
8,Main,Zilean,9,11.7,7,2,1,1,1
8,Main,Draven,8,10.4,6,2,1,1,1
8,Main,Azir,7,9.1,1,6,4,3,3
8,Main,Ekko,5,6.5,1,4,2,1,3
8,Main,Vel'Koz,5,6.5,3,2,2,1,1
8,Main,Graves,4,5.2,,4,3,1,3
8,Main,Jax,4,5.2,2,2,2,1,1
8,Main,Cho'Gath,3,3.9,,3,3,1,2
8,Main,Jarvan IV,3,3.9,,3,3,1,2
8,Main,Cassiopeia,3,3.9,,3,2,0,3
8,Main,Gangplank,3,3.9,1,2,2,1,1
8,Main,Nautilus,3,3.9,1,2,2,1,1
8,Main,Zoe,3,3.9,1,2,2,0,2
8,Main,Yasuo,3,3.9,2,1,1,1,0
8,Main,Zac,3,3.9,2,1,1,1,0
8,Main,Malzahar,3,3.9,2,1,1,0,1
8,Main,Kalista,2,2.6,,2,2,1,1
8,Main,Fiora,2,2.6,,2,1,0,2
8,Main,Hecarim,2,2.6,1,1,1,1,0
8,Main,Darius,2,2.6,2,0,,0,0
8,Main,Pyke,2,2.6,2,0,,0,0
8,Main,Ahri,1,1.3,,1,1,1,0
8,Main,Kled,1,1.3,,1,1,1,0
8,Main,Rek'Sai,1,1.3,,1,1,1,0
8,Main,Singed,1,1.3,,1,1,1,0
8,Main,Ashe,1,1.3,,1,1,0,1
8,Main,Bard,1,1.3,,1,1,0,1
8,Main,Brand,1,1.3,,1,1,0,1
8,Main,Elise,1,1.3,,1,1,0,1
8,Main,Evelynn,1,1.3,,1,1,0,1
8,Main,Kassadin,1,1.3,,1,1,0,1
8,Main,Lulu,1,1.3,,1,1,0,1
8,Main,Mordekaiser,1,1.3,,1,1,0,1
8,Main,Nami,1,1.3,,1,1,0,1
8,Main,Nidalee,1,1.3,,1,1,0,1
8,Main,Trundle,1,1.3,,1,1,0,1
9,Play in,Pantheon,43,100,42,1,1,1,0
9,Play in,Syndra,41,95.3,27,14,10,9,5
9,Play in,Xayah,38,88.4,15,23,11,11,12
9,Play in,Qiyana,38,88.4,30,8,7,5,3
9,Play in,Renekton,29,67.4,16,13,6,5,8
9,Play in,Rakan,28,65.1,8,20,8,10,10
9,Play in,Gangplank,28,65.1,16,12,7,7,5
9,Play in,LeBlanc,28,65.1,17,11,8,4,7
9,Play in,Thresh,27,62.8,7,20,9,8,12
9,Play in,Kai'Sa,26,60.5,5,21,10,12,9
9,Play in,Gragas,26,60.5,18,8,5,6,2
9,Play in,Nautilus,23,53.5,8,15,9,8,7
9,Play in,Akali,22,51.2,8,14,6,5,9
9,Play in,Lee Sin,21,48.8,5,16,7,11,5
9,Play in,Elise,21,48.8,12,9,6,5,4
9,Play in,Rek'Sai,18,41.9,9,9,5,4,5
9,Play in,Tristana,18,41.9,10,8,7,6,2
9,Play in,Gnar,16,37.2,6,10,5,7,3
9,Play in,Twisted Fate,15,34.9,9,6,4,3,3
9,Play in,Morgana,14,32.6,9,5,1,3,2
9,Play in,Nocturne,13,30.2,5,8,7,2,6
9,Play in,Vladimir,13,30.2,7,6,3,3,3
9,Play in,Skarner,13,30.2,7,6,5,1,5
9,Play in,Irelia,13,30.2,9,4,4,1,3
9,Play in,Lucian,12,27.9,5,7,6,3,4
9,Play in,Pyke,12,27.9,6,6,5,3,3
9,Play in,Yuumi,12,27.9,8,4,2,2,2
9,Play in,Olaf,12,27.9,10,2,2,1,1
9,Play in,Ezreal,11,25.6,2,9,6,5,4
9,Play in,Jarvan IV,11,25.6,3,8,7,4,4
9,Play in,Heimerdinger,11,25.6,8,3,1,3,0
9,Play in,Ryze,10,23.3,4,6,5,5,1
9,Play in,Kayle,10,23.3,7,3,2,2,1
9,Play in,Camille,9,20.9,2,7,5,1,6
9,Play in,Kennen,8,18.6,3,5,3,4,1
9,Play in,Leona,8,18.6,3,5,4,3,2
9,Play in,Galio,8,18.6,5,3,3,1,2
9,Play in,Rumble,8,18.6,6,2,1,2,0
9,Play in,Corki,7,16.3,1,6,4,3,3
9,Play in,Ashe,7,16.3,3,4,4,2,2
9,Play in,Alistar,7,16.3,4,3,3,1,2
9,Play in,Caitlyn,7,16.3,4,3,3,0,3
9,Play in,Draven,7,16.3,6,1,1,1,0
9,Play in,Neeko,6,14,1,5,4,3,2
9,Play in,Taliyah,6,14,2,4,2,4,0
9,Play in,Kled,6,14,2,4,3,2,2
9,Play in,Lissandra,6,14,2,4,4,2,2
9,Play in,Yasuo,6,14,4,2,2,1,1
9,Play in,Orianna,5,11.6,1,4,4,2,2
9,Play in,Jayce,5,11.6,2,3,3,1,2
9,Play in,Karma,5,11.6,2,3,3,1,2
9,Play in,Karthus,5,11.6,2,3,2,1,2
9,Play in,Aatrox,4,9.3,,4,3,1,3
9,Play in,Ekko,4,9.3,,4,3,0,4
9,Play in,Sivir,4,9.3,1,3,3,1,2
9,Play in,Quinn,4,9.3,2,2,2,1,1
9,Play in,Shen,4,9.3,2,2,2,1,1
9,Play in,Cassiopeia,4,9.3,3,1,1,1,0
9,Play in,Mordekaiser,3,7,1,2,2,0,2
9,Play in,Ornn,3,7,2,1,1,1,0
9,Play in,Blitzcrank,2,4.7,,2,1,1,1
9,Play in,Cho'Gath,2,4.7,,2,1,1,1
9,Play in,Hecarim,2,4.7,,2,1,1,1
9,Play in,Jhin,2,4.7,,2,1,1,1
9,Play in,Azir,2,4.7,,2,2,0,2
9,Play in,Fiddlesticks,2,4.7,1,1,1,1,0
9,Play in,Veigar,2,4.7,1,1,1,1,0
9,Play in,Braum,2,4.7,1,1,1,0,1
9,Play in,Jinx,2,4.7,1,1,1,0,1
9,Play in,Fiora,1,2.3,,1,1,1,0
9,Play in,Kha'Zix,1,2.3,,1,1,1,0
9,Play in,Zoe,1,2.3,,1,1,1,0
9,Play in,Garen,1,2.3,,1,1,0,1
9,Play in,Lux,1,2.3,,1,1,0,1
9,Play in,Nidalee,1,2.3,,1,1,0,1
9,Play in,Sejuani,1,2.3,,1,1,0,1
9,Play in,Sylas,1,2.3,,1,1,0,1
9,Play in,Vi,1,2.3,,1,1,0,1
9,Play in,Xin Zhao,1,2.3,,1,1,0,1
9,Play in,Ziggs,1,2.3,,1,1,0,1
9,Play in,Jax,1,2.3,1,0,,0,0
9,Play in,Vayne,1,2.3,1,0,,0,0
9,Main,Pantheon,77,100,77,0,,0,0
9,Main,Qiyana,71,92.2,56,15,9,8,7
9,Main,Akali,67,87,46,21,16,12,9
9,Main,Renekton,66,85.7,46,20,12,12,8
9,Main,Xayah,64,83.1,30,34,14,24,10
9,Main,Kai'Sa,62,80.5,12,50,15,25,25
9,Main,Gragas,57,74,16,41,15,26,15
9,Main,Kayle,57,74,36,21,14,10,11
9,Main,Syndra,55,71.4,40,15,9,4,11
9,Main,Nautilus,54,70.1,17,37,14,20,17
9,Main,Ryze,52,67.5,22,30,12,17,13
9,Main,Lee Sin,50,64.9,8,42,14,19,23
9,Main,Elise,45,58.4,22,23,10,11,12
9,Main,Gangplank,44,57.1,18,26,11,14,12
9,Main,Rakan,43,55.8,20,23,10,13,10
9,Main,LeBlanc,37,48.1,27,10,7,7,3
9,Main,Jayce,27,35.1,11,16,6,7,9
9,Main,Yasuo,27,35.1,14,13,7,9,4
9,Main,Yuumi,27,35.1,18,9,4,3,6
9,Main,Ezreal,25,32.5,9,16,10,6,10
9,Main,Rek'Sai,25,32.5,12,13,10,7,6
9,Main,Leona,22,28.6,7,15,8,10,5
9,Main,Tristana,21,27.3,11,10,9,2,8
9,Main,Vladimir,20,26,9,11,5,6,5
9,Main,Jarvan IV,20,26,10,10,6,3,7
9,Main,Olaf,18,23.4,10,8,6,5,3
9,Main,Thresh,17,22.1,2,15,7,8,7
9,Main,Galio,17,22.1,5,12,9,4,8
9,Main,Twisted Fate,17,22.1,14,3,2,1,2
9,Main,Lucian,16,20.8,7,9,7,2,7
9,Main,Kled,15,19.5,10,5,4,3,2
9,Main,Irelia,15,19.5,11,4,4,2,2
9,Main,Rumble,15,19.5,12,3,2,1,2
9,Main,Alistar,14,18.2,3,11,6,4,7
9,Main,Morgana,14,18.2,10,4,3,2,2
9,Main,Ornn,13,16.9,4,9,6,6,3
9,Main,Pyke,13,16.9,6,7,6,1,6
9,Main,Veigar,13,16.9,8,5,4,2,3
9,Main,Camille,12,15.6,5,7,5,7,0
9,Main,Blitzcrank,12,15.6,6,6,5,2,4
9,Main,Tahm Kench,11,14.3,4,7,4,5,2
9,Main,Varus,10,13,1,9,4,6,3
9,Main,Orianna,10,13,1,9,6,5,4
9,Main,Gnar,10,13,2,8,7,4,4
9,Main,Aatrox,9,11.7,2,7,6,4,3
9,Main,Cassiopeia,9,11.7,2,7,5,3,4
9,Main,Heimerdinger,9,11.7,5,4,3,1,3
9,Main,Quinn,9,11.7,7,2,2,1,1
9,Main,Garen,8,10.4,1,7,3,3,4
9,Main,Sion,7,9.1,,7,6,1,6
9,Main,Taliyah,7,9.1,2,5,3,2,3
9,Main,Nocturne,7,9.1,3,4,3,1,3
9,Main,Fiora,7,9.1,4,3,3,1,2
9,Main,Shen,6,7.8,,6,5,2,4
9,Main,Vayne,6,7.8,4,2,1,2,0
9,Main,Jax,5,6.5,4,1,1,1,0
9,Main,Zoe,4,5.2,,4,4,1,3
9,Main,Mordekaiser,4,5.2,,4,2,0,4
9,Main,Cho'Gath,4,5.2,1,3,3,1,2
9,Main,Kennen,4,5.2,2,2,2,1,1
9,Main,Skarner,4,5.2,2,2,2,0,2
9,Main,Azir,3,3.9,,3,2,1,2
9,Main,Poppy,3,3.9,,3,3,1,2
9,Main,Draven,3,3.9,1,2,1,1,1
9,Main,Lissandra,3,3.9,1,2,2,1,1
9,Main,Karthus,3,3.9,1,2,2,0,2
9,Main,Karma,3,3.9,2,1,1,1,0
9,Main,Corki,2,2.6,,2,1,1,1
9,Main,Jinx,2,2.6,,2,2,1,1
9,Main,Lulu,2,2.6,,2,2,1,1
9,Main,Sivir,2,2.6,1,1,1,1,0
9,Main,Sona,2,2.6,1,1,1,0,1
9,Main,Sylas,2,2.6,1,1,1,0,1
9,Main,Volibear,2,2.6,1,1,1,0,1
9,Main,Braum,2,2.6,2,0,,0,0
9,Main,Jhin,2,2.6,2,0,,0,0
9,Main,Kalista,2,2.6,2,0,,0,0
9,Main,Ekko,1,1.3,,1,1,1,0
9,Main,Fiddlesticks,1,1.3,,1,1,1,0
9,Main,Kog'Maw,1,1.3,,1,1,1,0
9,Main,Malphite,1,1.3,,1,1,1,0
9,Main,Urgot,1,1.3,,1,1,1,0
9,Main,Yorick,1,1.3,,1,1,1,0
9,Main,Anivia,1,1.3,,1,1,0,1
9,Main,Bard,1,1.3,,1,1,0,1
9,Main,Caitlyn,1,1.3,,1,1,0,1
9,Main,Kha'Zix,1,1.3,,1,1,0,1
9,Main,Neeko,1,1.3,,1,1,0,1
9,Main,Rengar,1,1.3,,1,1,0,1
9,Main,Sejuani,1,1.3,,1,1,0,1
9,Main,Viktor,1,1.3,,1,1,0,1
9,Main,Zilean,1,1.3,,1,1,0,1
10,Play in,Nidalee,34,89.5,23,11,6,7,4
10,Play in,Lillia,33,86.8,17,16,6,5,11
10,Play in,Orianna,33,86.8,22,11,8,10,1
10,Play in,Ornn,33,86.8,22,11,6,10,1
10,Play in,Graves,29,76.3,12,17,8,12,5
10,Play in,Renekton,27,71.1,16,11,6,5,6
10,Play in,Sett,26,68.4,11,15,9,6,9
10,Play in,Leona,25,65.8,7,18,6,9,9
10,Play in,Camille,24,63.2,11,13,8,7,6
10,Play in,Lucian,23,60.5,18,5,4,3,2
10,Play in,Nautilus,22,57.9,11,11,6,4,7
10,Play in,Senna,21,55.3,6,15,7,7,8
10,Play in,Shen,21,55.3,15,6,3,4,2
10,Play in,Rakan,19,50,6,13,8,8,5
10,Play in,Ezreal,18,47.4,5,13,7,8,5
10,Play in,Alistar,18,47.4,7,11,8,9,2
10,Play in,Ashe,18,47.4,8,10,6,2,8
10,Play in,Twitch,18,47.4,10,8,6,4,4
10,Play in,Bard,17,44.7,12,5,4,2,3
10,Play in,Syndra,16,42.1,7,9,5,5,4
10,Play in,Twisted Fate,16,42.1,9,7,3,4,3
10,Play in,Caitlyn,15,39.5,11,4,3,2,2
10,Play in,Jhin,14,36.8,2,12,7,8,4
10,Play in,Galio,14,36.8,5,9,4,2,7
10,Play in,Hecarim,14,36.8,8,6,4,3,3
10,Play in,Azir,14,36.8,10,4,2,2,2
10,Play in,Zoe,12,31.6,5,7,6,2,5
10,Play in,Akali,12,31.6,11,1,1,0,1
10,Play in,Wukong,11,28.9,1,10,4,4,6
10,Play in,Volibear,11,28.9,5,6,3,2,4
10,Play in,Mordekaiser,10,26.3,6,4,3,1,3
10,Play in,Kalista,10,26.3,9,1,1,0,1
10,Play in,Thresh,9,23.7,7,2,2,0,2
10,Play in,Evelynn,8,21.1,5,3,2,2,1
10,Play in,Kindred,7,18.4,1,6,3,5,1
10,Play in,Sion,7,18.4,2,5,3,1,4
10,Play in,Sylas,7,18.4,2,5,5,1,4
10,Play in,Braum,6,15.8,1,5,5,2,3
10,Play in,Lee Sin,6,15.8,2,4,4,1,3
10,Play in,Kassadin,6,15.8,3,3,2,3,0
10,Play in,Pantheon,6,15.8,5,1,1,1,0
10,Play in,Malphite,5,13.2,3,2,1,1,1
10,Play in,Tristana,4,10.5,,4,4,2,2
10,Play in,Miss Fortune,4,10.5,1,3,2,2,1
10,Play in,Ziggs,4,10.5,1,3,3,1,2
10,Play in,Cassiopeia,3,7.9,1,2,2,1,1
10,Play in,Ekko,3,7.9,1,2,1,1,1
10,Play in,Elise,3,7.9,1,2,1,1,1
10,Play in,Lulu,3,7.9,1,2,1,1,1
10,Play in,Jax,3,7.9,2,1,1,1,0
10,Play in,Karthus,3,7.9,2,1,1,0,1
10,Play in,Gangplank,2,5.3,,2,2,1,1
10,Play in,Vayne,2,5.3,,2,2,1,1
10,Play in,Taric,2,5.3,,2,1,0,2
10,Play in,Morgana,2,5.3,1,1,1,1,0
10,Play in,Swain,2,5.3,1,1,1,1,0
10,Play in,Tahm Kench,2,5.3,1,1,1,0,1
10,Play in,Gnar,1,2.6,,1,1,1,0
10,Play in,Karma,1,2.6,,1,1,1,0
10,Play in,Aatrox,1,2.6,,1,1,0,1
10,Play in,Aphelios,1,2.6,,1,1,0,1
10,Play in,Corki,1,2.6,,1,1,0,1
10,Play in,Draven,1,2.6,,1,1,0,1
10,Play in,Gragas,1,2.6,,1,1,0,1
10,Play in,Jarvan IV,1,2.6,,1,1,0,1
10,Play in,Kayle,1,2.6,,1,1,0,1
10,Play in,Kog'Maw,1,2.6,,1,1,0,1
10,Play in,Poppy,1,2.6,,1,1,0,1
10,Play in,Skarner,1,2.6,,1,1,0,1
10,Play in,Urgot,1,2.6,,1,1,0,1
10,Play in,Vladimir,1,2.6,,1,1,0,1
10,Play in,Xayah,1,2.6,,1,1,0,1
10,Play in,Blitzcrank,1,2.6,1,0,,0,0
10,Play in,LeBlanc,1,2.6,1,0,,0,0
10,Play in,Lux,1,2.6,1,0,,0,0
10,Play in,Olaf,1,2.6,1,0,,0,0
10,Play in,Quinn,1,2.6,1,0,,0,0
10,Play in,Vel'Koz,1,2.6,1,0,,0,0
10,Main,Lucian,71,93.4,60,11,9,6,5
10,Main,Graves,70,92.1,18,52,16,23,29
10,Main,Ornn,69,90.8,40,29,13,14,15
10,Main,Syndra,68,89.5,40,28,13,14,14
10,Main,Nidalee,68,89.5,48,20,9,11,9
10,Main,Twisted Fate,62,81.6,46,16,7,9,7
10,Main,Camille,56,73.7,42,14,8,8,6
10,Main,Ashe,52,68.4,20,32,13,15,17
10,Main,Renekton,52,68.4,30,22,10,8,14
10,Main,Senna,43,56.6,12,31,15,14,17
10,Main,Jhin,42,55.3,11,31,12,20,11
10,Main,Leona,42,55.3,18,24,9,17,7
10,Main,Orianna,40,52.6,12,28,13,15,13
10,Main,Ezreal,40,52.6,19,21,7,12,9
10,Main,Sett,40,52.6,23,17,14,9,8
10,Main,Caitlyn,39,51.3,28,11,6,6,5
10,Main,Lillia,38,50,13,25,10,12,13
10,Main,Pantheon,38,50,21,17,10,10,7
10,Main,Volibear,36,47.4,14,22,12,12,10
10,Main,Shen,32,42.1,24,8,6,5,3
10,Main,Tahm Kench,29,38.2,14,15,7,8,7
10,Main,Kindred,28,36.8,9,19,8,11,8
10,Main,Bard,27,35.5,12,15,9,9,6
10,Main,Kalista,25,32.9,17,8,5,2,6
10,Main,Thresh,24,31.6,14,10,7,4,6
10,Main,Rakan,23,30.3,9,14,9,7,7
10,Main,Sylas,20,26.3,9,11,5,7,4
10,Main,Galio,19,25,4,15,8,6,9
10,Main,Nautilus,18,23.7,5,13,8,2,11
10,Main,Gangplank,18,23.7,7,11,6,5,6
10,Main,Lulu,17,22.4,7,10,7,5,5
10,Main,Azir,15,19.7,5,10,6,3,7
10,Main,Akali,14,18.4,9,5,3,3,2
10,Main,Twitch,14,18.4,12,2,2,0,2
10,Main,Lee Sin,13,17.1,3,10,6,4,6
10,Main,Jax,12,15.8,5,7,3,5,2
10,Main,Zoe,11,14.5,3,8,5,5,3
10,Main,Jayce,11,14.5,3,8,7,2,6
10,Main,Ekko,10,13.2,3,7,5,5,2
10,Main,Braum,10,13.2,3,7,5,4,3
10,Main,Evelynn,10,13.2,6,4,4,2,2
10,Main,Alistar,9,11.8,3,6,6,0,6
10,Main,Aphelios,8,10.5,2,6,5,3,3
10,Main,Lux,8,10.5,3,5,4,2,3
10,Main,Karma,8,10.5,4,4,4,3,1
10,Main,Blitzcrank,8,10.5,4,4,3,2,2
10,Main,Hecarim,8,10.5,4,4,4,2,2
10,Main,Wukong,8,10.5,5,3,2,1,2
10,Main,Irelia,8,10.5,6,2,2,1,1
10,Main,Sion,7,9.2,1,6,3,3,3
10,Main,Kennen,7,9.2,3,4,1,4,0
10,Main,Gragas,6,7.9,3,3,3,2,1
10,Main,Vladimir,6,7.9,3,3,2,2,1
10,Main,Swain,6,7.9,6,0,,0,0
10,Main,Miss Fortune,5,6.6,,5,4,3,2
10,Main,Jarvan IV,5,6.6,2,3,2,2,1
10,Main,Kassadin,5,6.6,3,2,2,0,2
10,Main,Mordekaiser,5,6.6,3,2,2,0,2
10,Main,Malphite,4,5.3,,4,4,2,2
10,Main,Yuumi,4,5.3,4,0,,0,0
10,Main,Taric,3,3.9,,3,2,1,2
10,Main,Draven,3,3.9,1,2,2,1,1
10,Main,Fiora,2,2.6,,2,2,1,1
10,Main,Vel'Koz,2,2.6,,2,2,0,2
10,Main,Ziggs,2,2.6,,2,1,0,2
10,Main,Zilean,2,2.6,,2,1,0,2
10,Main,Karthus,2,2.6,1,1,1,0,1
10,Main,Gnar,1,1.3,,1,1,1,0
10,Main,Maokai,1,1.3,,1,1,1,0
10,Main,Nocturne,1,1.3,,1,1,1,0
10,Main,Rengar,1,1.3,,1,1,1,0
10,Main,Singed,1,1.3,,1,1,1,0
10,Main,Vayne,1,1.3,,1,1,1,0
10,Main,Kayle,1,1.3,,1,1,0,1
10,Main,Kha'Zix,1,1.3,,1,1,0,1
10,Main,LeBlanc,1,1.3,,1,1,0,1
10,Main,Quinn,1,1.3,,1,1,0,1
10,Main,Ryze,1,1.3,,1,1,0,1
10,Main,Urgot,1,1.3,,1,1,0,1
10,Main,Morgana,1,1.3,1,0,,0,0
11,Play in,Miss Fortune,37,97.4,8,29,10,16,13
11,Play in,Lee Sin,36,94.7,15,21,8,11,10
11,Play in,Irelia,36,94.7,26,10,5,5,5
11,Play in,Lucian,35,92.1,21,14,7,6,8
11,Play in,Leona,33,86.8,9,24,8,19,5
11,Play in,Xin Zhao,29,76.3,14,15,7,5,10
11,Play in,Ryze,26,68.4,17,9,5,4,5
11,Play in,LeBlanc,26,68.4,20,6,5,2,4
11,Play in,Kennen,24,63.2,16,8,5,4,4
11,Play in,Camille,23,60.5,17,6,4,4,2
11,Play in,Ezreal,22,57.9,8,14,7,6,8
11,Play in,Rakan,22,57.9,8,14,7,6,8
11,Play in,Sylas,22,57.9,9,13,8,6,7
11,Play in,Amumu,22,57.9,11,11,7,3,8
11,Play in,Jayce,18,47.4,7,11,7,3,8
11,Play in,Qiyana,18,47.4,13,5,4,4,1
11,Play in,Aphelios,17,44.7,10,7,7,5,2
11,Play in,Zoe,16,42.1,11,5,5,3,2
11,Play in,Lillia,15,39.5,7,8,5,4,4
11,Play in,Gwen,15,39.5,10,5,3,3,2
11,Play in,Tryndamere,14,36.8,9,5,4,3,2
11,Play in,Braum,12,31.6,5,7,4,3,4
11,Play in,Jarvan IV,12,31.6,6,6,6,3,3
11,Play in,Twisted Fate,12,31.6,8,4,2,2,2
11,Play in,Yone,12,31.6,8,4,3,0,4
11,Play in,Talon,10,26.3,4,6,3,3,3
11,Play in,Gnar,10,26.3,4,6,5,2,4
11,Play in,Draven,10,26.3,9,1,1,1,0
11,Play in,Nami,9,23.7,4,5,4,2,3
11,Play in,Gangplank,9,23.7,5,4,3,1,3
11,Play in,Orianna,7,18.4,2,5,4,2,3
11,Play in,Syndra,7,18.4,3,4,2,4,0
11,Play in,Nidalee,7,18.4,3,4,2,3,1
11,Play in,Azir,6,15.8,2,4,2,3,1
11,Play in,Thresh,6,15.8,2,4,4,2,2
11,Play in,Poppy,6,15.8,5,1,1,1,0
11,Play in,Wukong,5,13.2,,5,5,3,2
11,Play in,Graves,5,13.2,,5,4,2,3
11,Play in,Renekton,5,13.2,1,4,3,2,2
11,Play in,Kai'Sa,5,13.2,2,3,2,2,1
11,Play in,Jax,5,13.2,3,2,2,1,1
11,Play in,Kassadin,5,13.2,5,0,,0,0
11,Play in,Taliyah,4,10.5,1,3,2,3,0
11,Play in,Aatrox,4,10.5,1,3,3,2,1
11,Play in,Sett,4,10.5,1,3,3,2,1
11,Play in,Olaf,4,10.5,1,3,2,1,2
11,Play in,Galio,4,10.5,3,1,1,0,1
11,Play in,Yuumi,4,10.5,4,0,,0,0
11,Play in,Gragas,3,7.9,,3,3,3,0
11,Play in,Fiora,3,7.9,,3,3,2,1
11,Play in,Akali,3,7.9,,3,3,1,2
11,Play in,Kled,3,7.9,,3,2,1,2
11,Play in,Urgot,3,7.9,1,2,1,2,0
11,Play in,Alistar,3,7.9,1,2,2,0,2
11,Play in,Malphite,3,7.9,2,1,1,1,0
11,Play in,Nocturne,3,7.9,2,1,1,1,0
11,Play in,Sion,3,7.9,2,1,1,1,0
11,Play in,Nautilus,3,7.9,2,1,1,0,1
11,Play in,Ziggs,3,7.9,3,0,,0,0
11,Play in,Senna,2,5.3,,2,1,1,1
11,Play in,Xayah,2,5.3,,2,2,1,1
11,Play in,Zed,2,5.3,,2,2,1,1
11,Play in,Trundle,2,5.3,,2,2,0,2
11,Play in,Tahm Kench,2,5.3,1,1,1,1,0
11,Play in,Kalista,2,5.3,1,1,1,0,1
11,Play in,Karma,2,5.3,1,1,1,0,1
11,Play in,Ornn,2,5.3,1,1,1,0,1
11,Play in,Rumble,2,5.3,1,1,1,0,1
11,Play in,Sejuani,2,5.3,1,1,1,0,1
11,Play in,Yasuo,2,5.3,2,0,,0,0
11,Play in,Bard,1,2.6,,1,1,1,0
11,Play in,Lissandra,1,2.6,,1,1,1,0
11,Play in,Jhin,1,2.6,,1,1,0,1
11,Play in,Lulu,1,2.6,,1,1,0,1
11,Play in,Rell,1,2.6,,1,1,0,1
11,Play in,Shen,1,2.6,,1,1,0,1
11,Play in,Tristana,1,2.6,,1,1,0,1
11,Play in,Vayne,1,2.6,,1,1,0,1
11,Play in,Viego,1,2.6,,1,1,0,1
11,Play in,Seraphine,1,2.6,1,0,,0,0
11,Main,Lee Sin,82,98.8,45,37,16,22,15
11,Main,Twisted Fate,80,96.4,56,24,12,13,11
11,Main,Yuumi,80,96.4,65,15,10,8,7
11,Main,LeBlanc,74,89.2,51,23,12,13,10
11,Main,Graves,65,78.3,29,36,15,21,15
11,Main,Aphelios,65,78.3,34,31,11,19,12
11,Main,Lucian,65,78.3,45,20,7,12,8
11,Main,Jarvan IV,64,77.1,33,31,16,14,17
11,Main,Miss Fortune,61,73.5,10,51,15,22,29
11,Main,Ryze,56,67.5,32,24,11,11,13
11,Main,Xin Zhao,55,66.3,25,30,13,10,20
11,Main,Leona,54,65.1,22,32,14,11,21
11,Main,Irelia,54,65.1,45,9,9,2,7
11,Main,Kennen,51,61.4,29,22,14,16,6
11,Main,Jayce,46,55.4,23,23,11,10,13
11,Main,Rakan,45,54.2,16,29,14,18,11
11,Main,Nami,33,39.8,20,13,5,7,6
11,Main,Jhin,30,36.1,2,28,11,18,10
11,Main,Thresh,30,36.1,18,12,9,7,5
11,Main,Viego,25,30.1,7,18,9,10,8
11,Main,Sylas,24,28.9,8,16,13,8,8
11,Main,Syndra,24,28.9,9,15,8,10,5
11,Main,Gwen,23,27.7,9,14,9,4,10
11,Main,Talon,23,27.7,11,12,6,7,5
11,Main,Zoe,22,26.5,8,14,8,9,5
11,Main,Azir,22,26.5,12,10,6,4,6
11,Main,Draven,22,26.5,18,4,3,1,3
11,Main,Olaf,20,24.1,12,8,5,3,5
11,Main,Lulu,19,22.9,3,16,6,9,7
11,Main,Ezreal,19,22.9,8,11,8,6,5
11,Main,Braum,19,22.9,8,11,9,4,7
11,Main,Qiyana,19,22.9,9,10,5,7,3
11,Main,Renekton,16,19.3,4,12,4,6,6
11,Main,Camille,16,19.3,9,7,6,4,3
11,Main,Orianna,15,18.1,3,12,9,4,8
11,Main,Poppy,15,18.1,5,10,6,5,5
11,Main,Ziggs,15,18.1,6,9,6,3,6
11,Main,Nautilus,14,16.9,4,10,8,5,5
11,Main,Rell,12,14.5,3,9,5,5,4
11,Main,Trundle,11,13.3,5,6,4,3,3
11,Main,Galio,11,13.3,8,3,2,1,2
11,Main,Gnar,10,12,2,8,5,3,5
11,Main,Kai'Sa,10,12,2,8,6,3,5
11,Main,Sett,9,10.8,6,3,3,1,2
11,Main,Tryndamere,9,10.8,6,3,3,0,3
11,Main,Lissandra,8,9.6,3,5,3,4,1
11,Main,Jax,7,8.4,,7,6,3,4
11,Main,Gragas,7,8.4,1,6,5,2,4
11,Main,Wukong,7,8.4,4,3,2,2,1
11,Main,Amumu,7,8.4,6,1,1,1,0
11,Main,Alistar,5,6,,5,5,2,3
11,Main,Yasuo,5,6,1,4,4,2,2
11,Main,Malzahar,5,6,2,3,3,2,1
11,Main,Gangplank,5,6,3,2,2,2,0
11,Main,Malphite,5,6,3,2,2,0,2
11,Main,Urgot,5,6,5,0,,0,0
11,Main,Aatrox,4,4.8,1,3,3,2,1
11,Main,Tristana,4,4.8,1,3,2,2,1
11,Main,Rumble,4,4.8,1,3,2,1,2
11,Main,Fiddlesticks,4,4.8,2,2,1,1,1
11,Main,Jinx,4,4.8,3,1,1,0,1
11,Main,Taliyah,4,4.8,3,1,1,0,1
11,Main,Zilean,3,3.6,,3,2,2,1
11,Main,Pyke,3,3.6,,3,3,1,2
11,Main,Shen,3,3.6,,3,3,1,2
11,Main,Viktor,3,3.6,,3,2,0,3
11,Main,Annie,3,3.6,1,2,1,1,1
11,Main,Varus,3,3.6,1,2,1,0,2
11,Main,Fiora,2,2.4,,2,1,2,0
11,Main,Lillia,2,2.4,,2,2,1,1
11,Main,Maokai,2,2.4,,2,1,1,1
11,Main,Kassadin,2,2.4,1,1,1,1,0
11,Main,Kalista,2,2.4,1,1,1,0,1
11,Main,Xayah,2,2.4,1,1,1,0,1
11,Main,Ashe,1,1.2,,1,1,0,1
11,Main,Sejuani,1,1.2,,1,1,0,1
11,Main,Seraphine,1,1.2,,1,1,0,1
11,Main,Shaco,1,1.2,,1,1,0,1
11,Main,Yone,1,1.2,,1,1,0,1
11,Main,Vladimir,1,1.2,1,0,,0,0
12,Play in,Aatrox,45,95.7,21,24,12,17,7
12,Play in,Sylas,39,83,21,18,9,12,6
12,Play in,Kalista,37,78.7,30,7,7,3,4
12,Play in,Maokai,35,74.5,13,22,11,15,7
12,Play in,Sejuani,34,72.3,15,19,10,8,11
12,Play in,Hecarim,31,66,17,14,7,7,7
12,Play in,Caitlyn,28,59.6,24,4,4,0,4
12,Play in,Kai'Sa,27,57.4,10,17,11,9,8
12,Play in,Miss Fortune,26,55.3,9,17,9,8,9
12,Play in,Amumu,26,55.3,13,13,7,10,3
12,Play in,Azir,25,53.2,14,11,6,5,6
12,Play in,Gnar,24,51.1,8,16,6,9,7
12,Play in,Aphelios,24,51.1,12,12,8,6,6
12,Play in,Graves,24,51.1,16,8,6,4,4
12,Play in,Leona,23,48.9,5,18,10,8,10
12,Play in,LeBlanc,23,48.9,15,8,6,4,4
12,Play in,Yuumi,23,48.9,17,6,4,4,2
12,Play in,Nautilus,22,46.8,13,9,8,2,7
12,Play in,Akali,19,40.4,10,9,6,6,3
12,Play in,Taliyah,19,40.4,10,9,6,2,7
12,Play in,Alistar,18,38.3,7,11,7,4,7
12,Play in,Trundle,18,38.3,9,9,4,4,5
12,Play in,Draven,17,36.2,15,2,1,0,2
12,Play in,Viktor,14,29.8,4,10,8,5,5
12,Play in,Seraphine,14,29.8,8,6,3,2,4
12,Play in,Ornn,13,27.7,9,4,3,1,3
12,Play in,Tristana,11,23.4,3,8,4,6,2
12,Play in,Fiora,11,23.4,6,5,4,3,2
12,Play in,Poppy,11,23.4,9,2,2,1,1
12,Play in,Lee Sin,10,21.3,4,6,4,4,2
12,Play in,Kennen,10,21.3,4,6,3,3,3
12,Play in,Tahm Kench,10,21.3,5,5,4,5,0
12,Play in,Galio,9,19.1,3,6,4,1,5
12,Play in,Lissandra,9,19.1,4,5,4,2,3
12,Play in,Vi,9,19.1,5,4,3,1,3
12,Play in,Renekton,9,19.1,7,2,2,0,2
12,Play in,Viego,8,17,,8,4,5,3
12,Play in,Vex,8,17,2,6,3,3,3
12,Play in,Braum,8,17,3,5,4,1,4
12,Play in,Jax,8,17,3,5,3,1,4
12,Play in,Ezreal,8,17,4,4,4,3,1
12,Play in,Gwen,8,17,4,4,3,1,3
12,Play in,Rell,7,14.9,3,4,4,3,1
12,Play in,Camille,7,14.9,3,4,4,1,3
12,Play in,Xayah,7,14.9,4,3,3,0,3
12,Play in,Pantheon,7,14.9,6,1,1,0,1
12,Play in,Sett,6,12.8,,6,6,2,4
12,Play in,Bel'Veth,6,12.8,3,3,1,2,1
12,Play in,Renata Glasc,6,12.8,3,3,2,1,2
12,Play in,Swain,6,12.8,4,2,2,1,1
12,Play in,Ahri,6,12.8,5,1,1,1,0
12,Play in,Sivir,5,10.6,,5,3,4,1
12,Play in,Lillia,5,10.6,1,4,3,1,3
12,Play in,Yone,5,10.6,2,3,2,2,1
12,Play in,Varus,4,8.5,,4,3,4,0
12,Play in,Thresh,4,8.5,2,2,1,2,0
12,Play in,Mordekaiser,4,8.5,2,2,2,1,1
12,Play in,Olaf,4,8.5,3,1,1,1,0
12,Play in,Jarvan IV,4,8.5,3,1,1,0,1
12,Play in,Shen,3,6.4,,3,3,2,1
12,Play in,Wukong,3,6.4,,3,3,1,2
12,Play in,Gangplank,3,6.4,1,2,1,2,0
12,Play in,Zac,3,6.4,1,2,1,1,1
12,Play in,Morgana,3,6.4,1,2,2,0,2
12,Play in,Nilah,3,6.4,1,2,2,0,2
12,Play in,Rakan,3,6.4,1,2,2,0,2
12,Play in,Zoe,3,6.4,2,1,1,1,0
12,Play in,Taric,2,4.3,1,1,1,1,0
12,Play in,Irelia,2,4.3,1,1,1,0,1
12,Play in,Lux,2,4.3,1,1,1,0,1
12,Play in,Samira,2,4.3,1,1,1,0,1
12,Play in,Karma,2,4.3,2,0,,0,0
12,Play in,Gragas,1,2.1,,1,1,1,0
12,Play in,Jinx,1,2.1,,1,1,1,0
12,Play in,Lucian,1,2.1,,1,1,1,0
12,Play in,Nami,1,2.1,,1,1,1,0
12,Play in,Syndra,1,2.1,,1,1,1,0
12,Play in,Vayne,1,2.1,,1,1,1,0
12,Play in,Ashe,1,2.1,,1,1,0,1
12,Play in,Garen,1,2.1,,1,1,0,1
12,Play in,Rumble,1,2.1,,1,1,0,1
12,Play in,Sion,1,2.1,,1,1,0,1
12,Play in,Soraka,1,2.1,,1,1,0,1
12,Play in,Teemo,1,2.1,,1,1,0,1
12,Play in,Tryndamere,1,2.1,,1,1,0,1
12,Play in,Vladimir,1,2.1,,1,1,0,1
12,Play in,Xin Zhao,1,2.1,,1,1,0,1
12,Play in,Zilean,1,2.1,,1,1,0,1
12,Play in,Nocturne,1,2.1,1,0,,0,0
12,Play in,Pyke,1,2.1,1,0,,0,0
12,Main,Aatrox,80,100,58,22,12,12,10
12,Main,Yuumi,76,95,68,8,6,8,0
12,Main,Sejuani,72,90,42,30,17,16,14
12,Main,Caitlyn,70,87.5,62,8,5,5,3
12,Main,Azir,66,82.5,29,37,13,19,18
12,Main,Sylas,60,75,28,32,10,21,11
12,Main,Graves,59,73.8,34,25,11,12,13
12,Main,Maokai,56,70,35,21,14,7,14
12,Main,Lucian,55,68.8,29,26,9,15,11
12,Main,Viego,48,60,18,30,9,19,11
12,Main,Akali,48,60,24,24,11,12,12
12,Main,Fiora,42,52.5,23,19,10,9,10
12,Main,Renata Glasc,41,51.2,20,21,10,13,8
12,Main,Aphelios,39,48.8,8,31,10,17,14
12,Main,Renekton,39,48.8,23,16,9,5,11
12,Main,Viktor,35,43.8,16,19,10,6,13
12,Main,Kalista,31,38.8,13,18,10,7,11
12,Main,Ornn,31,38.8,15,16,11,9,7
12,Main,Nami,27,33.8,1,26,9,15,11
12,Main,Varus,27,33.8,8,19,10,9,10
12,Main,Lee Sin,23,28.7,8,15,9,7,8
12,Main,Poppy,22,27.5,9,13,9,4,9
12,Main,LeBlanc,22,27.5,14,8,4,3,5
12,Main,Camille,21,26.3,10,11,5,8,3
12,Main,Heimerdinger,21,26.3,13,8,3,4,4
12,Main,Vi,18,22.5,6,12,8,6,6
12,Main,Nautilus,18,22.5,11,7,6,1,6
12,Main,Lulu,16,20,1,15,7,8,7
12,Main,Jax,16,20,5,11,7,5,6
12,Main,Jarvan IV,16,20,8,8,6,2,6
12,Main,Gragas,14,17.5,3,11,7,8,3
12,Main,Gnar,14,17.5,5,9,5,4,5
12,Main,Taliyah,14,17.5,7,7,4,3,4
12,Main,Lissandra,14,17.5,9,5,4,3,2
12,Main,Kai'Sa,13,16.3,5,8,6,5,3
12,Main,Thresh,13,16.3,6,7,4,4,3
12,Main,Ashe,13,16.3,7,6,3,4,2
12,Main,Draven,13,16.3,7,6,5,3,3
12,Main,Soraka,12,15,3,9,6,4,5
12,Main,Leona,12,15,3,9,7,2,7
12,Main,Trundle,12,15,5,7,4,4,3
12,Main,Ryze,12,15,8,4,2,3,1
12,Main,Amumu,11,13.8,5,6,4,2,4
12,Main,Bel'Veth,11,13.8,5,6,5,1,5
12,Main,Sivir,10,12.5,2,8,6,7,1
12,Main,Karma,10,12.5,3,7,5,2,5
12,Main,Tristana,10,12.5,4,6,6,1,5
12,Main,Yone,10,12.5,5,5,2,5,0
12,Main,Miss Fortune,9,11.3,1,8,4,2,6
12,Main,Rell,9,11.3,3,6,5,4,2
12,Main,Gangplank,9,11.3,5,4,3,2,2
12,Main,Lux,8,10,1,7,6,3,4
12,Main,Tahm Kench,8,10,2,6,5,2,4
12,Main,Ezreal,8,10,3,5,4,1,4
12,Main,Kindred,8,10,4,4,1,4,0
12,Main,Galio,8,10,4,4,4,1,3
12,Main,Syndra,7,8.8,2,5,4,0,5
12,Main,Ahri,6,7.5,1,5,4,4,1
12,Main,Sett,6,7.5,1,5,4,2,3
12,Main,Hecarim,6,7.5,2,4,3,3,1
12,Main,Jinx,6,7.5,2,4,3,3,1
12,Main,Seraphine,6,7.5,2,4,3,0,4
12,Main,Senna,6,7.5,3,3,3,0,3
12,Main,Nidalee,6,7.5,4,2,2,1,1
12,Main,Pyke,6,7.5,5,1,1,0,1
12,Main,Jayce,5,6.3,2,3,2,3,0
12,Main,Kennen,5,6.3,2,3,3,1,2
12,Main,Braum,4,5,2,2,1,2,0
12,Main,Alistar,4,5,2,2,2,1,1
12,Main,Kayn,4,5,2,2,1,0,2
12,Main,Orianna,3,3.8,,3,3,2,1
12,Main,Swain,3,3.8,1,2,2,1,1
12,Main,Karthus,3,3.8,2,1,1,1,0
12,Main,Nocturne,3,3.8,2,1,1,1,0
12,Main,Bard,2,2.5,,2,2,1,1
12,Main,Blitzcrank,2,2.5,,2,2,1,1
12,Main,Gwen,2,2.5,,2,2,1,1
12,Main,Jhin,2,2.5,,2,2,1,1
12,Main,Xayah,2,2.5,,2,2,1,1
12,Main,Rakan,2,2.5,1,1,1,1,0
12,Main,Darius,2,2.5,1,1,1,0,1
12,Main,Fiddlesticks,2,2.5,1,1,1,0,1
12,Main,Singed,2,2.5,1,1,1,0,1
12,Main,Mordekaiser,2,2.5,2,0,,0,0
12,Main,Nilah,2,2.5,2,0,,0,0
12,Main,Shen,1,1.3,,1,1,1,0
12,Main,Anivia,1,1.3,,1,1,0,1
12,Main,Irelia,1,1.3,,1,1,0,1
12,Main,Malphite,1,1.3,,1,1,0,1
12,Main,Nasus,1,1.3,,1,1,0,1
12,Main,Rumble,1,1.3,,1,1,0,1
12,Main,Wukong,1,1.3,,1,1,0,1
12,Main,Xin Zhao,1,1.3,,1,1,0,1
12,Main,Olaf,1,1.3,1,0,,0,0
